23
7
11111111111111111111111
10000000000000000000001
10000000000000000000001
000000000000000000e0001
10000000000000000000001
10000000000000000000001
11111111111111111111111