23
7
11111111111111111111111
10000000000000000000001
10000000000000000000001
100000000000000e0000001
10000000000000000000001
10000000000000000000001
11011111110111111111111