23
7
11011111110111111111111
10000000000100000000001
10000000000100000e00001
00000@00001110000000000
10000000000100000000001
10000000000000000000001
11011111110111111111111